Gal Gun – Critical Hit
The Avalanches – We Will Always Love You 
Various Artists – Warm Violet: A Compilation for Chicago Community Jail Support 
Call Me Spinster – Call Me Spinster 
The Flat Five – Another World 
Doug Carn, Adrian Younge and Ali Shaheed Muhammad – Doug Carn JID005 
The Twilite Tone – The Clearing 
ShowYouSuck – Comfy, Cozy, Cardigan, Cutie 
Heather Trost – Petrichor 
Emily Edrosa – Another Wave Is Coming 
Common – A Beautiful Revolution Pt. 1 
M. Ward – Think of Spring 
Astute Palate – Astute Palate 
Luke Titus – Plasma 
Aesop Rock – Spirit World Field Guide 
All Natural x Panik – Dark Night 
Guided by Voices – Styles We Paid For 
Easter Island – Take All The Time You Think You Need 
Pågå – The Evil Year 
Mac Blackout – Love Profess 
Josephine Foster – No Harm Done 
Jenny Lewis & Serengeti – "Unblu" [single] 
Leila – Like Weather 
Joan of Arc – Tim Melina Theo Bobby 
Mars Williams – Mars Williams Presents An Ayler Xmas Vol. 4: Chicago vs. NYC 
Rob Mazurek & Exploding Star Orchestra – Dimensional Stardust 
Mamalarky – Mamalarky 
Teenanger – Good Time 
Katy J Pearson – Return 
Sol y Canto – ¡En vivo, en familia! 
Fir Cone Children – Waterslide At 7 A.M. 
Bootsy Collins – The Power of the One 
Half Japanese – Crazy Hearts 
Savoy Motel – Love Your Face 
Immaterial Possession – Immaterial Possession 
Jordan Reyes – Sand Like Stardust 
Joey Molland – Be True to Yourself 
Shygirl – ALIAS 
Audrey Foxx – Stone Cold Woman 
The Embryos – SCV3 
The Reds, Pinks and Purples – You Might Be Happy Someday 
The Bats – Foothills 
The Toms – The 1979 Sessions 
Bootchy Temple – In Consummated Bloom 
Carabobina – Carabobina 
Night Lunch – Wall of Love 
Lars Finberg – Tinnitus Tonight 
Cabaret Voltaire – Shadow of Fear 
TSHA – Flowers 
Potatohead People – Mellow Fantasy 