Ichiko Aoba - Windswept Adan
Boldy James & Sterling Toles - Manger on McNichols
The Koreatown Oddity - Little Dominiques Nosebleed
Liturgy - Origin of the Alimonies
Undeath - Lesions of a Different Kind
Chris Stapleton - Starting Over
Bring Me the Horizon - Post Human: Survival Horror
Adrianne Lenker - Songs
clipping. - Visions of Bodies Being Burned
Gorillaz - Song Machine, Season One: Strange Timez
Dorian Electra - My Agenda
Idles - Ultra Mono
Slauson Malone - Vergangenheitsbewältigung
Sevdaliza - Shabrang
The Flaming Lips - American Head
Conway the Machine - From King to a GOD
Meridian Brothers - Cumbia Siglo XXI
Matmos - The Consuming Flame: Open Exercises in Group Form
Tkay Maidza - Last Year Was Weird Vol. 2
Imperial Triumphant - Alphaville
Blu & Exile - Miles
Lianne La Havas - Lianne La Havas
Boris - NO
Jessie Ware - What’s Your Pleasure?
HAIM - Women in Music Pt. III
Phoebe Bridgers - Punisher
Moor Jewelry - True Opera
Chloe x Halle - Ungodly Hour
Run the Jewels - RTJ4
Deerhoof - Future Teenage Cave Artists
Freddie Gibbs & The Alchemist - Alfredo
Backxwash - God Has Nothing to Do With This Leave Him Out of It
Jeff Rosenstock - NO DREAM
Perfume Genius - Set My Heart on Fire Immediately
Charli XCX - how i’m feeling now
Natalia Lafourcade - Un canto por México Vol. 1
Dope Body - Home Body
Black Dresses - Peaceful as Hell
Quelle Chris & Chris Keys - Innocent Country 2
Lido Pimienta - Miss Colombia
Rina Sawayama - Sawayama
Laura Marling - Song for Our Daughter
The Strokes - The New Abnormal
Dirty Projectors - Windows Open
Nicolas Jaar - Cenizas
Horse Lords - The Common Task
Haru Nemuri - Lovetheism
R.A.P. Ferreira - Purple Moonlight Pages
Code Orange - Underneath
Disclosure - Ecstasy
King Krule - Man Alive!
HMLTD - West of Eden
Against All Logic - 2017–2019
Denzel Curry x Kenny Beats - Unlocked
Dan Deacon - Mystic Familiar
Poppy - I Disagree
Stormzy - Heavy Is the Head
Mac Miller - Circles