Adult. - Perception Is/As/Of Deception
Alien Nosejob – Once Again The Present Is The Past 
Marisa Anderson & Jim White – The Quickening 
Atramentus - Stygian 
The Bats – Foothills 
Chubby & The Gang - Speed Kills LP
Sarah Davachi – Cantus, Descent 
James Elkington – Ever Roving Eye 
Flavor Crystals – Five 
Geld – Beyond The Floor 
Gen Pop – PPM66 
Glok – Dissident 
Holy Wave – Interloper 
Hum – Inlet 
Jahara Massamba Unit - Pardon My French 
Jarv Is – Beyond The Pale 
Lavender Flu – Barbarian Dust 
Lithics – Tower Of Age 
Sophia Loizou – Untold 
Mackaya McCraven – Universal Beings E&F Sides 
Malignus Youth - Live at the Rialto Theater 2014 
Melanas – Dias Raros 
Bill Nace – Both 
David Nance – Staunch Honey 
Thiago Nassif – Mente 
Necrot – Mortal 
Negative Gears – Self Titled 
Primo – Sogni 
Ribbon Stage – My Favorite Shrine 
Ringo Deathstarr – Self Titled
Run the Jewels – RTJ4 
Six Organs Of Admittance - Companion Rises 
Skeleton – Self Titled
Smokescreens – A Strange Dream 
Sorry – 925
Special Interest – The Passion Of 
Sweeping Promises – Hunger For A Way Out 
Trees Speak – Ohms 
Waxahatchee - Saint Cloud
Wax Chattels – Clot 
Joshua Wentz – Lifted Into Depths 
Widowspeak – Plum 
Windy & Carl – Allegiance and Conviction 
V/A – Situation Chicago 